.........................
.........................
..........X..............
.......######............
..G..............G.......
####..G.G.G.G....###.....
.......G.G.GCG...........
......--------...........
...--...........--.......
.........................
.GBG............G.G......
####............####.....
.........................
.1...........A...C.......
########..###############
